14 14 14 14 14 14 14 14 14 14 14 14 14 14 14 14 14 14 14 14 14 14 14 14 14 14 14 14 14 14 14 14 14 14 14 14 14 14 14 14
14 14 14 14 14 14 14 14 14 14 14 14 14 14 14 14 14 14 14 14 14 14 14 14 14 14 14 14 14 14 14 14 14 14 14 14 14 14 14 14
14 14 14 14 14 14 14 14 14 14 14 14 14 14 14 14 14 14 14 14 14 14 14 14 14 14 14 14 14 14 14 14 14 14 14 14 14 14 14 14
14 14 14 14 14 14 14 14 14 14 14 14 14 14 14 14 14 14 14 14 14 14 14 14 14 14 14 14 14 14 14 14 14 14 14 14 14 14 14 14
14 14 14 14 14 14 14 14 14 14 14 14 14 14 14 14 14 14 14 14 14 14 14 14 14 14 14 14 14 14 14 14 14 14 14 14 14 14 14 14
14 14 14 14 14 14 14 14 14 14 14 14 14 14 14 14 14 14 14 14 14 14 14 14 14 14 14 14 14 14 14 14 14 14 14 14 14 14 14 14
14 14 14 14 14 14 10 10 10 10 10 10 10 10 10 10 10 10 10 34 35 10 10 10 10 10 10 10 10 10 10 10 10 10 14 14 14 14 14 14
14 14 14 14 14 14 10 10 10 10 10 10 10 10 10 10 10 10 10 37 36 10 10 10 10 10 10 10 10 10 10 10 10 10 14 14 14 14 14 14
14 14 14 14 14 14 10 10 10 10 10 10 10 33 10 10 10 10 14 12 10 14 10 10 10 10 10 10 14 33 10 10 10 10 14 14 14 14 14 14
14 14 14 14 14 14 41 16 13 13 13 13 13 13 20 13 13 13 13 18 13 13 13 13 13 13 13 13 20 13 13 13 17 41 14 14 14 14 14 14
14 14 14 14 14 14 10 12 33 38 39 10 26 28 12 10 10 10 40 12 42 10 10 39 38 10 40 38 12 10 26 28 12 10 14 14 14 14 14 14
14 14 14 14 14 14 10 12 40 10 10 10 25 27 12 10 10 10 10 12 10 10 10 10 10 10 10 39 12 10 25 27 12 10 14 14 14 14 14 14
14 14 14 14 14 14 10 12 39 10 10 10 10 10 12 38 10 10 33 12 10 10 10 38 10 10 10 10 12 10 10 10 12 10 14 14 14 14 14 14
14 14 14 14 14 14 10 12 10 10 10 10 10 41 23 13 13 13 13 21 13 13 13 17 40 10 30 29 12 10 10 10 12 10 14 14 14 14 14 14
14 14 14 14 14 14 10 12 30 29 10 10 10 10 12 42 10 10 40 39 10 26 28 12 10 10 32 31 12 10 10 10 12 10 14 14 14 14 14 14
14 14 14 14 14 14 10 12 32 31 14 10 10 10 12 30 29 10 10 10 10 25 27 12 33 10 10 10 12 10 10 14 12 10 14 14 14 14 14 14
14 14 14 14 14 14 10 12 10 10 10 10 10 33 12 32 31 10 10 10 10 10 10 23 13 13 13 13 19 38 10 40 12 10 14 14 14 14 14 14
14 14 14 14 14 14 10 23 13 13 13 13 13 13 22 10 10 10 14 14 10 10 38 12 38 10 10 40 39 10 10 10 12 10 14 14 14 14 14 14
14 14 14 14 14 14 10 12 26 28 10 10 10 39 12 10 10 10 10 10 10 10 10 12 40 10 10 10 10 10 10 10 12 10 14 14 14 14 14 14
14 14 14 14 14 14 10 12 25 27 10 10 10 10 12 26 28 10 10 10 10 10 10 12 10 10 10 10 10 10 30 29 12 10 14 14 14 14 14 14
14 14 14 14 14 14 10 12 10 10 10 10 40 38 12 25 27 10 39 10 10 41 33 12 14 10 39 10 10 33 32 31 12 10 14 14 14 14 14 14
14 14 14 14 14 14 10 12 14 39 16 13 13 13 21 13 13 13 20 13 13 13 13 21 13 13 13 20 13 13 13 13 22 41 14 14 14 14 14 14
14 14 14 14 14 14 10 12 10 10 12 26 28 10 10 14 38 14 12 42 10 10 30 29 10 38 40 12 42 10 39 38 12 10 14 14 14 14 14 14
14 14 14 14 14 14 10 12 33 10 12 25 27 10 10 10 10 39 12 10 10 10 32 31 10 10 10 12 38 10 10 40 12 10 14 14 14 14 14 14
14 14 14 14 14 14 10 23 13 13 22 10 10 10 10 10 10 10 12 10 10 10 10 10 10 10 10 12 39 10 10 40 12 10 14 14 14 14 14 14
14 14 14 14 14 14 10 12 38 10 12 10 10 10 10 10 30 29 12 26 28 10 10 10 10 30 29 12 40 38 10 10 12 10 14 14 14 14 14 14
14 14 14 14 14 14 10 12 10 10 12 40 10 41 10 10 32 31 12 25 27 14 10 33 10 32 31 12 10 10 10 41 12 10 14 14 14 14 14 14
14 14 14 14 14 14 10 12 41 10 15 13 13 13 20 13 13 13 21 13 13 13 13 13 20 13 13 19 10 10 10 10 12 10 14 14 14 14 14 14
14 14 14 14 14 14 10 12 10 10 10 10 10 10 12 10 10 10 10 10 10 10 10 10 12 10 10 10 10 10 10 10 12 10 14 14 14 14 14 14
11 11 11 11 11 11 11 24 11 11 11 11 11 11 24 11 11 11 11 11 11 11 11 11 24 11 11 11 11 11 11 11 24 11 11 11 11 11 11 11
11 11 11 11 11 11 11 24 11 11 11 11 11 11 24 11 11 11 11 11 11 11 11 11 24 11 11 11 11 11 11 11 24 11 11 11 11 11 11 11
14 14 14 14 14 14 10 12 10 10 30 29 10 10 12 10 10 10 10 10 10 10 10 10 12 10 10 26 28 10 10 10 12 10 14 14 14 14 14 14
14 14 14 14 14 14 10 12 14 10 32 31 10 14 12 33 40 10 10 38 39 10 10 33 12 41 14 25 27 10 10 14 12 10 14 14 14 14 14 14
14 14 14 14 14 14 10 15 13 13 13 13 13 13 21 13 13 13 13 13 13 13 13 13 21 13 13 13 13 13 13 13 19 10 14 14 14 14 14 14
14 14 14 14 14 14 14 14 14 14 14 14 14 14 14 14 14 14 14 14 14 14 14 14 14 14 14 14 14 14 14 14 14 14 14 14 14 14 14 14
14 14 14 14 14 14 14 14 14 14 14 14 14 14 14 14 14 14 14 14 14 14 14 14 14 14 14 14 14 14 14 14 14 14 14 14 14 14 14 14
14 14 14 14 14 14 14 14 14 14 14 14 14 14 14 14 14 14 14 14 14 14 14 14 14 14 14 14 14 14 14 14 14 14 14 14 14 14 14 14
14 14 14 14 14 14 14 14 14 14 14 14 14 14 14 14 14 14 14 14 14 14 14 14 14 14 14 14 14 14 14 14 14 14 14 14 14 14 14 14
14 14 14 14 14 14 14 14 14 14 14 14 14 14 14 14 14 14 14 14 14 14 14 14 14 14 14 14 14 14 14 14 14 14 14 14 14 14 14 14
14 14 14 14 14 14 14 14 14 14 14 14 14 14 14 14 14 14 14 14 14 14 14 14 14 14 14 14 14 14 14 14 14 14 14 14 14 14 14 14