0 0 0 0 0 2 0 0 0 0 0 0
1 1 1 1 1 4 1 1 1 1 1 1
1 1 1 1 1 4 1 1 1 1 1 1
0 0 0 0 0 2 0 0 0 0 0 0
0 6 3 3 3 8 3 3 3 3 7 0
0 2 0 0 0 2 0 0 0 0 2 0
0 2 0 0 0 2 0 0 0 0 2 0
0 2 0 0 0 2 0 0 0 0 2 0
0 2 0 0 0 2 0 0 0 0 2 0
0 5 3 3 3 8 3 3 3 3 9 0